111111111111111111111111
10010000000000C111111111
100001111111100111111111
1000011111111C0111111111
100001111111100111111111
100001111111100111111111
1P0000000E000C0111111111
111111111111111111111111
111111111111111111111111
111111111111111111111111
111111111111111111111111